11 10 9 8 8 8 8 8 8 9 10 11 11 12 13 14 15 16 17 19 19 19 19 19 19 19 19 19 19 19 19 19 19 19 19 19 19 19 19 19 19 19 19 19 19 19 19 19 19 19 
10 9 8 7 7 7 7 7 7 8 9 10 11 12 13 14 15 16 17 18 19 19 19 19 19 19 19 19 19 19 19 19 19 19 19 19 19 19 19 19 19 19 19 19 19 19 19 19 19 19 
10 9 8 7 6 6 6 6 7 8 9 10 11 12 13 14 15 16 17 18 19 19 19 19 19 19 19 19 19 19 19 19 19 19 19 19 19 19 19 19 19 19 19 19 19 19 19 19 19 19 
10 9 8 7 6 5 5 6 7 8 9 10 11 12 13 14 15 16 17 18 19 19 19 19 19 19 19 19 19 19 19 19 19 19 19 19 19 19 19 19 19 19 19 19 19 19 19 19 19 19 
10 9 8 7 6 5 4 6 7 8 9 10 11 12 13 14 19 19 19 19 19 19 19 19 19 19 19 19 19 19 19 19 19 19 19 19 19 19 19 19 19 19 19 19 19 19 19 19 19 19 
10 9 8 7 6 6 5 6 7 8 9 10 11 12 13 14 15 16 17 18 19 19 19 19 19 19 19 19 19 19 19 19 19 19 19 19 19 19 19 19 19 19 19 19 19 19 19 19 19 19 
10 9 8 7 7 7 6 7 7 8 9 10 11 12 13 14 15 16 17 18 19 19 19 19 19 19 19 19 19 19 19 19 19 19 19 19 19 19 19 19 19 19 19 19 19 19 19 19 19 19 
11 10 9 8 8 8 7 8 8 9 10 11 11 12 13 14 15 16 17 19 19 19 19 19 19 19 19 19 19 19 19 19 19 19 19 19 19 19 19 19 19 19 19 19 19 19 19 19 19 19 
11 10 10 9 9 9 8 9 9 10 10 11 12 13 14 19 15 16 17 18 19 19 19 19 19 19 19 19 19 19 19 19 19 19 19 19 19 19 19 19 19 19 19 19 19 19 19 19 19 19 
12 11 11 10 10 10 9 10 10 11 11 12 12 13 14 15 16 19 18 19 19 19 19 19 19 19 19 19 19 19 19 19 19 19 19 19 19 19 19 19 19 19 19 19 19 19 19 19 19 19 
12 12 11 11 11 11 10 11 11 11 12 12 13 14 15 15 19 17 18 19 19 19 19 19 19 19 19 19 19 19 19 19 19 19 19 19 19 19 19 19 19 19 19 19 19 19 19 19 19 19 
13 13 12 12 12 12 11 12 12 12 13 13 14 14 19 16 17 18 19 19 19 19 19 19 19 19 19 19 19 19 19 19 19 19 19 19 19 19 19 19 19 19 19 19 19 19 19 19 19 19 
14 14 13 13 13 13 12 13 13 13 14 14 15 19 16 19 17 19 19 19 19 19 19 19 19 19 19 19 19 19 19 19 19 19 19 19 19 19 19 19 19 19 19 19 19 19 19 19 19 19 
15 19 14 14 14 14 13 14 14 14 19 15 15 16 19 17 19 19 19 19 19 19 19 19 19 19 19 19 19 19 19 19 19 19 19 19 19 19 19 19 19 19 19 19 19 19 19 19 19 19 
16 15 15 15 15 15 14 15 15 15 15 16 19 17 17 19 19 19 19 19 19 19 19 19 19 19 19 19 19 19 19 19 19 19 19 19 19 19 19 19 19 19 19 19 19 19 19 19 19 19 
19 16 16 16 16 16 15 16 16 16 16 19 17 18 19 19 19 19 19 19 19 19 19 19 19 19 19 19 19 19 19 19 19 19 19 19 19 19 19 19 19 19 19 19 19 19 19 19 19 19 
18 17 17 17 17 17 16 17 17 17 17 18 18 19 19 19 19 19 19 19 19 19 19 19 19 19 19 19 19 19 19 19 19 19 19 19 19 19 19 19 19 19 19 19 19 19 19 19 19 19 
19 18 19 18 18 18 17 18 18 19 18 19 19 19 19 19 19 19 19 19 19 19 19 19 19 19 19 19 19 19 19 19 19 19 19 19 19 19 19 19 19 19 19 19 19 19 19 19 19 19 
19 19 19 19 19 19 18 19 19 19 19 19 19 19 19 19 19 19 19 19 19 19 19 19 19 19 19 19 19 19 19 19 19 19 19 19 19 19 19 19 19 19 19 19 19 19 19 19 19 19 
19 19 19 19 19 19 19 19 19 19 19 19 19 19 19 19 19 19 19 19 19 19 19 19 19 19 19 19 19 19 19 19 19 19 19 19 19 19 19 19 19 19 19 19 19 19 19 19 19 19 
19 19 19 19 19 19 19 19 19 19 19 19 19 19 19 19 19 19 19 19 19 19 19 19 19 19 19 19 19 19 19 19 19 19 19 19 19 19 19 19 19 19 19 19 19 19 19 19 19 19 
19 19 19 19 19 19 19 19 19 19 19 19 19 19 19 19 19 19 19 19 19 19 19 19 19 19 19 19 19 19 19 19 19 19 19 19 19 19 19 19 19 19 19 19 19 19 19 19 19 19 
19 19 19 19 19 19 19 19 19 19 19 19 19 19 19 19 19 19 19 19 19 19 19 19 18 19 18 18 18 19 18 18 19 18 19 19 19 19 19 19 19 19 19 19 19 19 19 19 19 19 
19 19 19 19 19 19 19 19 19 19 19 19 19 19 19 19 19 19 19 19 19 19 18 18 17 17 17 17 17 19 17 17 17 17 18 18 19 19 19 19 19 19 19 19 19 19 19 19 19 19 
19 19 19 19 19 19 19 19 19 19 19 19 19 19 19 19 19 19 19 19 19 18 17 19 16 16 16 16 16 19 16 16 16 16 19 17 18 19 19 19 19 19 19 19 19 19 19 19 19 19 
19 19 19 19 19 19 19 19 19 19 19 19 19 19 19 19 19 19 19 19 17 17 19 16 15 15 15 15 15 19 15 15 15 15 16 19 17 17 19 19 19 19 19 19 19 19 19 19 19 19 
19 19 19 19 19 19 19 19 19 19 19 19 19 19 19 19 19 19 19 17 19 16 15 15 19 14 14 14 14 14 14 14 14 19 15 15 16 19 17 19 19 19 19 19 19 19 19 19 19 19 
19 19 19 19 19 19 19 19 19 19 19 19 19 19 19 19 19 19 17 19 16 19 15 14 14 13 13 13 13 13 13 13 13 14 14 15 19 16 19 17 19 19 19 19 19 19 19 19 19 19 
19 19 19 19 19 19 19 19 19 19 19 19 19 19 19 19 19 18 17 16 19 14 14 13 13 12 12 12 12 12 12 12 12 13 13 14 14 19 16 17 18 19 19 19 19 19 19 19 19 19 
19 19 19 19 19 19 19 19 19 19 19 19 19 19 19 19 18 17 19 15 15 14 13 12 12 11 11 11 11 11 11 11 11 12 12 13 14 15 15 19 17 18 19 19 19 19 19 19 19 19 
19 19 19 19 19 19 19 19 19 19 19 19 19 19 19 19 18 19 16 15 14 13 12 12 11 11 10 10 10 10 10 10 11 11 12 12 13 14 15 16 19 18 19 19 19 19 19 19 19 19 
19 19 19 19 19 19 19 19 19 19 19 19 19 19 19 18 17 16 15 19 14 13 12 11 10 10 9 9 9 9 9 9 10 10 11 12 13 14 19 15 16 17 18 19 19 19 19 19 19 19 
19 19 19 19 19 19 19 19 19 19 19 19 19 19 19 19 17 16 15 14 13 12 11 11 10 9 8 8 8 8 8 8 9 10 11 11 12 13 14 15 16 17 19 19 19 19 19 19 19 19 
19 19 19 19 19 19 19 19 19 19 19 19 19 19 19 18 17 16 15 14 13 12 11 10 9 8 7 7 7 7 7 7 8 9 10 11 12 13 14 15 16 17 18 19 19 19 19 19 19 19 
19 19 19 19 19 19 19 19 19 19 19 19 19 19 19 18 17 16 15 14 13 12 11 10 9 8 7 6 6 6 6 7 8 9 10 11 12 13 14 15 16 17 18 19 19 19 19 19 19 19 
19 19 19 19 19 19 19 19 19 19 19 19 19 19 19 18 17 16 15 14 13 12 11 10 9 8 7 6 5 5 6 7 8 9 10 11 12 13 14 15 16 17 18 19 19 19 19 19 19 19 
19 19 19 19 19 19 19 19 19 19 19 19 19 19 19 19 19 19 19 14 13 12 11 10 9 8 7 6 5 4 6 7 8 9 10 11 12 13 14 19 19 19 19 19 19 19 19 19 19 19 
19 19 19 19 19 19 19 19 19 19 19 19 19 19 19 18 17 16 15 14 13 12 11 10 9 8 7 6 6 5 6 7 8 9 10 11 12 13 14 15 16 17 18 19 19 19 19 19 19 19 
19 19 19 19 19 19 19 19 19 19 19 19 19 19 19 18 17 16 15 14 13 12 11 10 9 8 7 7 7 6 7 7 8 9 10 11 12 13 14 15 16 17 18 19 19 19 19 19 19 19 
19 19 19 19 19 19 19 19 19 19 19 19 19 19 19 19 17 16 15 14 13 12 11 11 10 9 8 8 8 7 8 8 9 10 11 11 12 13 14 15 16 17 19 19 19 19 19 19 19 19 
19 19 19 19 19 19 19 19 19 19 19 19 19 19 19 18 17 16 15 19 14 13 12 11 10 10 9 9 9 8 9 9 10 10 11 12 13 14 19 15 16 17 18 19 19 19 19 19 19 19 
19 19 19 19 19 19 19 19 19 19 19 19 19 19 19 19 18 19 16 15 14 13 12 12 11 11 10 10 10 9 10 10 11 11 12 12 13 14 15 16 19 18 19 19 19 19 19 19 19 19 
19 19 19 19 19 19 19 19 19 19 19 19 19 19 19 19 18 17 19 15 15 14 13 12 12 11 11 11 11 10 11 11 11 12 12 13 14 15 15 19 17 18 19 19 19 19 19 19 19 19 
19 19 19 19 19 19 19 19 19 19 19 19 19 19 19 19 19 18 17 16 19 14 14 13 13 12 12 12 12 11 12 12 12 13 13 14 14 19 16 17 18 19 19 19 19 19 19 19 19 19 
19 19 19 19 19 19 19 19 19 19 19 19 19 19 19 19 19 19 17 19 16 19 15 14 14 13 13 13 13 12 13 13 13 14 14 15 19 16 19 17 19 19 19 19 19 19 19 19 19 19 
19 19 19 19 19 19 19 19 19 19 19 19 19 19 19 19 19 19 19 17 19 16 15 15 19 14 14 14 14 13 14 14 14 19 15 15 16 19 17 19 19 19 19 19 19 19 19 19 19 19 
19 19 19 19 19 19 19 19 19 19 19 19 19 19 19 19 19 19 19 19 17 17 19 16 15 15 15 15 15 14 15 15 15 15 16 19 17 17 19 19 19 19 19 19 19 19 19 19 19 19 
19 19 19 19 19 19 19 19 19 19 19 19 19 19 19 19 19 19 19 19 19 18 17 19 16 16 16 16 16 15 16 16 16 16 19 17 18 19 19 19 19 19 19 19 19 19 19 19 19 19 
19 19 19 19 19 19 19 19 19 19 19 19 19 19 19 19 19 19 19 19 19 19 18 18 17 17 17 17 17 16 17 17 17 17 18 18 19 19 19 19 19 19 19 19 19 19 19 19 19 19 
19 19 19 19 19 19 19 19 19 19 19 19 19 19 19 19 19 19 19 19 19 19 19 19 18 19 18 18 18 17 18 18 19 18 19 19 19 19 19 19 19 19 19 19 19 19 19 19 19 19 
