Map dimensions: 50 x 50

11 10 9 8 8 8 8 8 8 9 10 11 11 12 13 14 15 16 17 20 20 20 20 20 20 20 20 20 20 20 20 20 20 20 20 20 20 20 20 20 20 20 20 20 20 20 20 20 20 20 
10 9 8 7 7 7 7 7 7 8 9 10 11 12 13 14 15 16 17 18 19 20 20 20 20 20 20 20 20 20 20 20 20 20 20 20 20 20 20 20 20 20 20 20 20 20 20 20 20 20 
10 9 8 7 6 6 6 6 7 8 9 10 11 12 13 14 15 16 17 18 19 20 20 20 20 20 20 20 20 20 20 20 20 20 20 20 20 20 20 20 20 20 20 20 20 20 20 20 20 20 
10 9 8 7 6 5 5 6 7 8 9 10 11 12 13 14 15 16 17 18 19 20 20 20 20 20 20 20 20 20 20 20 20 20 20 20 20 20 20 20 20 20 20 20 20 20 20 20 20 20 
10 9 8 7 6 5 4 6 7 8 9 10 11 12 13 14 20 20 20 20 20 20 20 20 20 20 20 20 20 20 20 20 20 20 20 20 20 20 20 20 20 20 20 20 20 20 20 20 20 20 
10 9 8 7 6 6 5 6 7 8 9 10 11 12 13 14 15 16 17 18 19 20 20 20 20 20 20 20 20 20 20 20 20 20 20 20 20 20 20 20 20 20 20 20 20 20 20 20 20 20 
10 9 8 7 7 7 6 7 7 8 9 10 11 12 13 14 15 16 17 18 19 20 20 20 20 20 20 20 20 20 20 20 20 20 20 20 20 20 20 20 20 20 20 20 20 20 20 20 20 20 
11 10 9 8 8 8 7 8 8 9 10 11 11 12 13 14 15 16 17 20 20 20 20 20 20 20 20 20 20 20 20 20 20 20 20 20 20 20 20 20 20 20 20 20 20 20 20 20 20 20 
11 10 10 9 9 9 8 9 9 10 10 11 12 13 14 20 15 16 17 18 19 20 20 20 20 20 20 20 20 20 20 20 20 20 20 20 20 20 20 20 20 20 20 20 20 20 20 20 20 20 
12 11 11 10 10 10 9 10 10 11 11 12 12 13 14 15 16 20 18 19 20 20 20 20 20 20 20 20 20 20 20 20 20 20 20 20 20 20 20 20 20 20 20 20 20 20 20 20 20 20 
12 12 11 11 11 11 10 11 11 11 12 12 13 14 15 15 20 17 18 20 20 20 20 20 20 20 20 20 20 20 20 20 20 20 20 20 20 20 20 20 20 20 20 20 20 20 20 20 20 20 
13 13 12 12 12 12 11 12 12 12 13 13 14 14 20 16 17 18 20 19 20 20 20 20 20 20 20 20 20 20 20 20 20 20 20 20 20 20 20 20 20 20 20 20 20 20 20 20 20 20 
14 14 13 13 13 13 12 13 13 13 14 14 15 20 16 20 17 20 19 20 20 20 20 20 20 20 20 20 20 20 20 20 20 20 20 20 20 20 20 20 20 20 20 20 20 20 20 20 20 20 
15 20 14 14 14 14 13 14 14 14 20 15 15 16 20 17 20 19 20 20 20 20 20 20 20 20 20 20 20 20 20 20 20 20 20 20 20 20 20 20 20 20 20 20 20 20 20 20 20 20 
16 15 15 15 15 15 14 15 15 15 15 16 20 17 17 20 19 20 20 20 20 20 20 20 20 20 20 20 20 20 20 20 20 20 20 20 20 20 20 20 20 20 20 20 20 20 20 20 20 20 
20 16 16 16 16 16 15 16 16 16 16 20 17 18 20 19 20 20 20 20 20 20 20 20 20 20 20 20 20 20 20 20 20 20 20 20 20 20 20 20 20 20 20 20 20 20 20 20 20 20 
18 17 17 17 17 17 16 17 17 17 17 18 18 20 19 20 20 20 20 20 20 20 20 20 20 20 20 20 20 20 20 20 20 20 20 20 20 20 20 20 20 20 20 20 20 20 20 20 20 20 
19 18 20 18 18 18 17 18 18 20 18 19 20 19 20 20 20 20 20 20 20 20 20 20 20 20 20 20 20 20 20 20 20 20 20 20 20 20 20 20 20 20 20 20 20 20 20 20 20 20 
20 19 20 19 19 19 18 19 19 20 19 20 20 20 20 20 20 20 20 20 20 20 20 20 20 20 20 20 20 20 20 20 20 20 20 20 20 20 20 20 20 20 20 20 20 20 20 20 20 20 
20 20 20 20 20 20 19 20 20 20 20 20 20 20 20 20 20 20 20 20 20 20 20 20 20 20 20 20 20 20 20 20 20 20 20 20 20 20 20 20 20 20 20 20 20 20 20 20 20 20 
20 20 20 20 20 20 20 20 20 20 20 20 20 20 20 20 20 20 20 20 20 20 20 20 20 20 20 20 20 20 20 20 20 20 20 20 20 20 20 20 20 20 20 20 20 20 20 20 20 20 
20 20 20 20 20 20 20 20 20 20 20 20 20 20 20 20 20 20 20 20 20 20 20 20 19 20 19 19 19 20 19 19 20 19 20 20 20 20 20 20 20 20 20 20 20 20 20 20 20 20 
20 20 20 20 20 20 20 20 20 20 20 20 20 20 20 20 20 20 20 20 20 19 20 19 18 20 18 18 18 20 18 18 20 18 19 20 19 20 20 20 20 20 20 20 20 20 20 20 20 20 
20 20 20 20 20 20 20 20 20 20 20 20 20 20 20 20 20 20 20 20 19 20 18 18 17 17 17 17 17 20 17 17 17 17 18 18 20 19 20 20 20 20 20 20 20 20 20 20 20 20 
20 20 20 20 20 20 20 20 20 20 20 20 20 20 20 20 20 20 20 19 20 18 17 20 16 16 16 16 16 20 16 16 16 16 20 17 18 20 19 20 20 20 20 20 20 20 20 20 20 20 
20 20 20 20 20 20 20 20 20 20 20 20 20 20 20 20 20 20 19 20 17 17 20 16 15 15 15 15 15 20 15 15 15 15 16 20 17 17 20 19 20 20 20 20 20 20 20 20 20 20 
20 20 20 20 20 20 20 20 20 20 20 20 20 20 20 20 20 19 20 17 20 16 15 15 20 14 14 14 14 14 14 14 14 20 15 15 16 20 17 20 19 20 20 20 20 20 20 20 20 20 
20 20 20 20 20 20 20 20 20 20 20 20 20 20 20 20 19 20 17 20 16 20 15 14 14 13 13 13 13 13 13 13 13 14 14 15 20 16 20 17 20 19 20 20 20 20 20 20 20 20 
20 20 20 20 20 20 20 20 20 20 20 20 20 20 20 19 20 18 17 16 20 14 14 13 13 12 12 12 12 12 12 12 12 13 13 14 14 20 16 17 18 20 19 20 20 20 20 20 20 20 
20 20 20 20 20 20 20 20 20 20 20 20 20 20 20 20 18 17 20 15 15 14 13 12 12 11 11 11 11 11 11 11 11 12 12 13 14 15 15 20 17 18 20 20 20 20 20 20 20 20 
20 20 20 20 20 20 20 20 20 20 20 20 20 20 20 19 18 20 16 15 14 13 12 12 11 11 10 10 10 10 10 10 11 11 12 12 13 14 15 16 20 18 19 20 20 20 20 20 20 20 
20 20 20 20 20 20 20 20 20 20 20 20 20 20 19 18 17 16 15 20 14 13 12 11 10 10 9 9 9 9 9 9 10 10 11 12 13 14 20 15 16 17 18 19 20 20 20 20 20 20 
20 20 20 20 20 20 20 20 20 20 20 20 20 20 20 20 17 16 15 14 13 12 11 11 10 9 8 8 8 8 8 8 9 10 11 11 12 13 14 15 16 17 20 20 20 20 20 20 20 20 
20 20 20 20 20 20 20 20 20 20 20 20 20 20 19 18 17 16 15 14 13 12 11 10 9 8 7 7 7 7 7 7 8 9 10 11 12 13 14 15 16 17 18 19 20 20 20 20 20 20 
20 20 20 20 20 20 20 20 20 20 20 20 20 20 19 18 17 16 15 14 13 12 11 10 9 8 7 6 6 6 6 7 8 9 10 11 12 13 14 15 16 17 18 19 20 20 20 20 20 20 
20 20 20 20 20 20 20 20 20 20 20 20 20 20 19 18 17 16 15 14 13 12 11 10 9 8 7 6 5 5 6 7 8 9 10 11 12 13 14 15 16 17 18 19 20 20 20 20 20 20 
20 20 20 20 20 20 20 20 20 20 20 20 20 20 20 20 20 20 20 14 13 12 11 10 9 8 7 6 5 4 6 7 8 9 10 11 12 13 14 20 20 20 20 20 20 20 20 20 20 20 
20 20 20 20 20 20 20 20 20 20 20 20 20 20 19 18 17 16 15 14 13 12 11 10 9 8 7 6 6 5 6 7 8 9 10 11 12 13 14 15 16 17 18 19 20 20 20 20 20 20 
20 20 20 20 20 20 20 20 20 20 20 20 20 20 19 18 17 16 15 14 13 12 11 10 9 8 7 7 7 6 7 7 8 9 10 11 12 13 14 15 16 17 18 19 20 20 20 20 20 20 
20 20 20 20 20 20 20 20 20 20 20 20 20 20 20 20 17 16 15 14 13 12 11 11 10 9 8 8 8 7 8 8 9 10 11 11 12 13 14 15 16 17 20 20 20 20 20 20 20 20 
20 20 20 20 20 20 20 20 20 20 20 20 20 20 19 18 17 16 15 20 14 13 12 11 10 10 9 9 9 8 9 9 10 10 11 12 13 14 20 15 16 17 18 19 20 20 20 20 20 20 
20 20 20 20 20 20 20 20 20 20 20 20 20 20 20 19 18 20 16 15 14 13 12 12 11 11 10 10 10 9 10 10 11 11 12 12 13 14 15 16 20 18 19 20 20 20 20 20 20 20 
20 20 20 20 20 20 20 20 20 20 20 20 20 20 20 20 18 17 20 15 15 14 13 12 12 11 11 11 11 10 11 11 11 12 12 13 14 15 15 20 17 18 20 20 20 20 20 20 20 20 
20 20 20 20 20 20 20 20 20 20 20 20 20 20 20 19 20 18 17 16 20 14 14 13 13 12 12 12 12 11 12 12 12 13 13 14 14 20 16 17 18 20 19 20 20 20 20 20 20 20 
20 20 20 20 20 20 20 20 20 20 20 20 20 20 20 20 19 20 17 20 16 20 15 14 14 13 13 13 13 12 13 13 13 14 14 15 20 16 20 17 20 19 20 20 20 20 20 20 20 20 
20 20 20 20 20 20 20 20 20 20 20 20 20 20 20 20 20 19 20 17 20 16 15 15 20 14 14 14 14 13 14 14 14 20 15 15 16 20 17 20 19 20 20 20 20 20 20 20 20 20 
20 20 20 20 20 20 20 20 20 20 20 20 20 20 20 20 20 20 19 20 17 17 20 16 15 15 15 15 15 14 15 15 15 15 16 20 17 17 20 19 20 20 20 20 20 20 20 20 20 20 
20 20 20 20 20 20 20 20 20 20 20 20 20 20 20 20 20 20 20 19 20 18 17 20 16 16 16 16 16 15 16 16 16 16 20 17 18 20 19 20 20 20 20 20 20 20 20 20 20 20 
20 20 20 20 20 20 20 20 20 20 20 20 20 20 20 20 20 20 20 20 19 20 18 18 17 17 17 17 17 16 17 17 17 17 18 18 20 19 20 20 20 20 20 20 20 20 20 20 20 20 
20 20 20 20 20 20 20 20 20 20 20 20 20 20 20 20 20 20 20 20 20 19 20 19 18 20 18 18 18 17 18 18 20 18 19 20 19 20 20 20 20 20 20 20 20 20 20 20 20 20 
