26 34 25 24 24 23 23 23 23 23 23 23 23 24 24 25 34 26 34 27 34 29 30 31 32 33 34 34 34 34 34 34 34 34 34 34 34 34 34 34 34 34 34 34 34 34 34 34 34 34 
34 24 24 23 23 22 22 22 22 22 22 22 22 23 23 24 24 34 26 27 28 34 29 30 34 34 33 34 34 34 34 34 34 34 34 34 34 34 34 34 34 34 34 34 34 34 34 34 34 34 
25 24 23 22 22 21 21 21 21 21 21 21 21 22 22 23 24 25 25 34 27 28 34 30 31 32 34 34 34 34 34 34 34 34 34 34 34 34 34 34 34 34 34 34 34 34 34 34 34 34 
24 23 22 22 21 21 20 20 20 20 20 20 21 21 22 22 23 24 25 26 34 28 29 34 34 34 32 33 34 34 34 34 34 34 34 34 34 34 34 34 34 34 34 34 34 34 34 34 34 34 
24 23 22 21 20 20 19 19 19 19 19 19 20 20 21 22 23 24 34 25 26 27 28 29 30 31 34 34 34 34 34 34 34 34 34 34 34 34 34 34 34 34 34 34 34 34 34 34 34 34 
23 22 21 21 20 19 18 18 18 18 18 18 19 20 21 21 22 23 24 25 26 27 34 34 30 31 32 33 34 34 34 34 34 34 34 34 34 34 34 34 34 34 34 34 34 34 34 34 34 34 
23 22 21 20 19 18 17 17 17 17 17 17 18 19 20 21 22 23 24 25 26 27 28 29 34 34 34 34 34 34 34 34 34 34 34 34 34 34 34 34 34 34 34 34 34 34 34 34 34 34 
23 22 21 20 19 18 17 16 16 16 16 17 18 19 20 21 22 23 24 25 26 27 28 29 30 31 32 33 34 34 34 34 34 34 34 34 34 34 34 34 34 34 34 34 34 34 34 34 34 34 
23 22 21 20 19 18 17 16 15 15 16 17 18 19 20 21 22 23 24 25 26 27 28 29 30 31 32 33 34 34 34 34 34 34 34 34 34 34 34 34 34 34 34 34 34 34 34 34 34 34 
23 22 21 20 19 18 17 16 15 14 16 17 18 19 20 21 22 23 24 34 34 34 34 34 34 34 34 34 34 34 34 34 34 34 34 34 34 34 34 34 34 34 34 34 34 34 34 34 34 34 
23 22 21 20 19 18 17 16 16 15 16 17 18 19 20 21 22 23 24 25 26 27 28 29 30 31 32 33 34 34 34 34 34 34 34 34 34 34 34 34 34 34 34 34 34 34 34 34 34 34 
23 22 21 20 19 18 17 17 17 16 17 17 18 19 20 21 22 23 24 25 26 27 28 29 34 34 34 34 34 34 34 34 34 34 34 34 34 34 34 34 34 34 34 34 34 34 34 34 34 34 
23 22 21 21 20 19 18 18 18 17 18 18 19 20 21 21 22 23 24 25 26 27 34 34 30 31 32 33 34 34 34 34 34 34 34 34 34 34 34 34 34 34 34 34 34 34 34 34 34 34 
24 23 22 21 20 20 19 19 19 18 19 19 20 20 21 22 23 24 34 25 26 27 28 29 30 31 34 34 34 34 34 34 34 34 34 34 34 34 34 34 34 34 34 34 34 34 34 34 34 34 
24 23 22 22 21 21 20 20 20 19 20 20 21 21 22 22 23 24 25 26 34 28 29 34 34 34 32 33 34 34 34 34 34 34 34 34 34 34 34 34 34 34 34 34 34 34 34 34 34 34 
25 24 23 22 22 21 21 21 21 20 21 21 21 22 22 23 24 25 25 34 27 28 34 30 31 32 34 34 34 34 34 34 34 34 34 34 34 34 34 34 34 34 34 34 34 34 34 34 34 34 
34 24 24 23 23 22 22 22 22 21 22 22 22 23 23 24 24 34 26 27 28 34 29 30 34 34 33 34 34 34 34 34 34 34 34 34 34 34 34 34 34 34 34 34 34 34 34 34 34 34 
26 34 25 24 24 23 23 23 23 22 23 23 23 24 24 25 34 26 34 27 34 29 30 31 32 33 34 34 34 34 34 34 34 34 34 34 34 34 34 34 34 34 34 34 34 34 34 34 34 34 
34 26 25 25 34 24 24 24 24 23 24 24 24 34 25 25 26 34 27 34 29 34 34 31 34 34 34 34 34 34 34 34 34 34 34 34 34 34 34 34 34 34 34 34 34 34 34 34 34 34 
27 27 34 26 25 25 25 25 25 24 25 25 25 25 26 34 27 27 34 29 34 30 31 32 33 34 34 34 34 34 34 34 34 34 34 34 34 34 34 34 34 34 34 34 34 34 34 34 34 34 
34 28 27 34 26 26 26 26 26 25 26 26 26 26 34 27 28 34 29 34 30 34 32 34 34 34 34 34 34 34 34 34 34 34 34 34 34 34 34 34 34 34 34 34 34 34 34 34 34 34 
29 34 28 28 27 27 27 27 27 26 27 27 27 27 28 28 34 29 34 30 34 31 34 33 34 34 34 34 34 34 34 34 34 34 34 34 34 34 34 34 34 34 34 34 34 34 34 34 34 34 
30 29 34 29 28 34 28 28 28 27 28 28 34 28 29 34 29 30 34 31 32 34 33 34 34 34 34 34 34 34 34 34 34 34 34 34 34 34 34 34 34 34 34 34 34 34 34 34 34 34 
31 30 30 34 29 34 29 29 29 28 29 29 34 29 34 30 30 31 31 32 34 33 34 34 34 34 34 34 34 34 34 34 34 34 34 34 34 34 34 34 34 34 34 34 34 34 34 34 34 34 
32 34 31 34 30 30 34 30 30 29 30 34 30 30 34 31 34 32 34 33 34 34 34 34 34 34 34 34 34 34 34 34 34 34 34 34 34 34 34 34 34 34 34 34 34 34 34 34 34 34 
33 34 32 34 31 31 34 31 31 30 31 34 31 31 34 32 34 33 34 34 34 34 34 34 34 34 34 34 34 34 34 34 34 34 34 34 34 34 34 34 34 34 34 34 34 34 34 34 34 34 
34 33 34 32 34 32 34 32 32 31 32 34 32 34 32 34 33 34 34 34 34 34 34 34 34 34 34 34 34 34 34 34 34 34 34 34 34 34 34 34 34 34 34 34 34 34 34 34 34 34 
34 34 34 33 34 33 34 33 33 32 33 34 33 34 33 34 34 34 34 34 34 34 34 34 34 34 34 34 34 34 34 34 34 34 34 34 34 34 34 34 34 34 34 34 34 34 34 34 34 34 
34 34 34 34 34 34 34 34 34 33 34 34 34 34 34 34 34 34 34 34 34 34 34 34 34 34 34 34 34 34 34 34 34 34 34 34 34 34 34 34 34 34 34 34 34 34 34 34 34 34 
34 34 34 34 34 34 34 34 34 34 34 34 34 34 34 34 34 34 34 34 34 34 34 34 34 34 34 34 34 34 34 34 34 34 34 34 34 34 34 34 34 34 34 34 34 34 34 34 34 34 
34 34 34 34 34 34 34 34 34 34 34 34 34 34 34 34 34 34 34 34 34 34 34 34 34 34 34 34 34 34 34 34 34 34 34 34 34 34 34 34 34 34 34 34 34 34 34 34 34 34 
34 34 34 34 34 34 34 34 34 34 34 34 34 34 34 34 34 34 34 34 34 34 34 34 34 34 34 34 34 34 34 34 34 34 34 34 34 34 34 34 34 34 34 34 34 34 34 34 34 34 
34 34 34 34 34 34 34 34 34 34 34 34 34 34 34 34 34 34 34 34 34 34 34 34 34 34 34 34 34 34 34 34 34 34 34 34 34 34 34 34 34 34 34 34 34 34 34 34 34 34 
34 34 34 34 34 34 34 34 34 34 34 34 34 34 34 34 34 34 34 34 34 34 34 34 34 34 34 34 34 34 34 34 34 34 34 34 34 34 34 34 34 34 34 34 34 34 34 34 34 34 
34 34 34 34 34 34 34 34 34 34 34 34 34 34 34 34 34 34 34 34 34 34 34 34 34 34 34 34 34 34 34 34 34 34 34 34 34 34 34 34 34 34 34 34 34 34 34 34 34 34 
34 34 34 34 34 34 34 34 34 34 34 34 34 34 34 34 34 34 34 34 34 34 34 34 34 34 34 34 34 34 34 34 34 34 34 33 33 33 33 33 33 33 33 34 34 34 34 34 34 34 
34 34 34 34 34 34 34 34 34 34 34 34 34 34 34 34 34 34 34 34 34 34 34 34 34 34 34 34 34 34 34 34 34 33 33 32 32 32 32 32 32 32 32 33 33 34 34 34 34 34 
34 34 34 34 34 34 34 34 34 34 34 34 34 34 34 34 34 34 34 34 34 34 34 34 34 34 34 34 34 34 34 34 33 32 32 31 31 31 31 31 31 31 31 32 32 33 34 34 34 34 
34 34 34 34 34 34 34 34 34 34 34 34 34 34 34 34 34 34 34 34 34 34 34 34 34 34 34 34 34 34 34 33 32 32 31 31 30 30 30 30 30 30 31 31 32 32 33 34 34 34 
34 34 34 34 34 34 34 34 34 34 34 34 34 34 34 34 34 34 34 34 34 34 34 34 34 34 34 34 34 34 34 33 32 31 30 30 29 29 29 29 29 29 30 30 31 32 33 34 34 34 
34 34 34 34 34 34 34 34 34 34 34 34 34 34 34 34 34 34 34 34 34 34 34 34 34 34 34 34 34 34 33 32 31 31 30 29 28 28 28 28 28 28 29 30 31 31 32 33 34 34 
34 34 34 34 34 34 34 34 34 34 34 34 34 34 34 34 34 34 34 34 34 34 34 34 34 34 34 34 34 34 33 32 31 30 29 28 27 27 27 27 27 27 28 29 30 31 32 33 34 34 
34 34 34 34 34 34 34 34 34 34 34 34 34 34 34 34 34 34 34 34 34 34 34 34 34 34 34 34 34 34 33 32 31 30 29 28 27 26 26 26 26 27 28 29 30 31 32 33 34 34 
34 34 34 34 34 34 34 34 34 34 34 34 34 34 34 34 34 34 34 34 34 34 34 34 34 34 34 34 34 34 33 32 31 30 29 28 27 26 25 25 26 27 28 29 30 31 32 33 34 34 
34 34 34 34 34 34 34 34 34 34 34 34 34 34 34 34 34 34 34 34 34 34 34 34 34 34 34 34 34 34 33 32 31 30 29 28 27 26 25 24 26 27 28 29 30 31 32 33 34 34 
34 34 34 34 34 34 34 34 34 34 34 34 34 34 34 34 34 34 34 34 34 34 34 34 34 34 34 34 34 34 33 32 31 30 29 28 27 26 26 25 26 27 28 29 30 31 32 33 34 34 
34 34 34 34 34 34 34 34 34 34 34 34 34 34 34 34 34 34 34 34 34 34 34 34 34 34 34 34 34 34 33 32 31 30 29 28 27 27 27 26 27 27 28 29 30 31 32 33 34 34 
34 34 34 34 34 34 34 34 34 34 34 34 34 34 34 34 34 34 34 34 34 34 34 34 34 34 34 34 34 34 33 32 31 31 30 29 28 28 28 27 28 28 29 30 31 31 32 33 34 34 
34 34 34 34 34 34 34 34 34 34 34 34 34 34 34 34 34 34 34 34 34 34 34 34 34 34 34 34 34 34 34 33 32 31 30 30 29 29 29 28 29 29 30 30 31 32 33 34 34 34 
34 34 34 34 34 34 34 34 34 34 34 34 34 34 34 34 34 34 34 34 34 34 34 34 34 34 34 34 34 34 34 33 32 32 31 31 30 30 30 29 30 30 31 31 32 32 33 34 34 34 
